16 12
0 0 0 0 0 0 0 0 2 0 0 0 0 0 0 0
0 0 0 0 0 0 1 5 0 5 1 0 0 0 0 0
0 0 0 0 0 0 1 5 0 5 1 0 0 0 0 0
0 0 0 0 0 0 1 5 0 5 1 0 0 0 0 0
0 0 0 0 0 0 1 5 0 5 1 0 0 0 0 0
0 0 0 0 1 1 1 5 0 5 1 1 1 0 0 0
0 0 0 0 1 5 5 0 0 3 5 5 1 0 0 0
0 0 0 0 1 5 0 4 3 0 0 5 1 0 0 0
0 0 0 0 1 5 0 3 0 4 0 5 1 0 0 0
0 0 0 0 1 5 0 8 7 6 0 5 1 0 0 0
0 0 0 0 1 1 1 3 1 3 1 1 1 0 0 0
0 0 0 0 0 0 0 0 0 0 0 0 0 0 0 0