16 12
0 0 0 0 0 0 0 0 0 0 0 0 0 0 0 0
0 0 0 0 0 0 0 0 0 0 0 0 0 0 0 0
0 0 0 0 0 0 0 0 0 0 0 0 0 0 0 0
0 0 0 0 8 7 6 0 0 0 0 0 0 0 0 0
0 0 0 0 1 1 1 1 0 1 1 1 1 0 0 0
0 0 0 0 0 1 1 1 0 1 1 1 2 0 0 0
0 0 0 0 0 1 0 4 0 0 0 1 0 0 0 0
0 0 0 0 0 1 0 3 0 4 0 1 0 0 0 0
0 0 0 0 0 1 1 0 0 1 1 1 0 0 0 0
0 0 0 0 0 0 1 1 1 1 0 0 0 0 0 0
0 0 0 0 0 0 0 0 0 0 0 0 0 0 0 0
0 0 0 0 0 0 0 0 0 0 0 0 0 0 0 0