16 12
0 0 0 0 0 0 0 0 0 0 0 0 0 0 0 0
0 0 0 0 0 0 0 4 0 0 0 0 0 0 0 0
0 0 0 0 0 0 0 1 0 0 0 0 0 0 0 0
0 0 0 0 0 0 0 0 0 0 0 0 0 0 0 0
0 0 0 0 0 0 1 0 1 0 0 0 0 0 0 0
0 0 0 7 6 0 0 0 0 0 0 5 0 2 0 0
0 0 0 8 1 1 0 5 0 1 1 1 1 1 0 0
0 0 0 0 0 1 0 1 0 1 0 0 0 0 0 0
0 0 0 0 0 1 0 3 0 1 0 0 0 0 0 0
0 0 0 0 0 1 1 1 0 1 0 0 0 0 0 0
0 0 0 0 0 0 0 1 1 1 0 0 0 0 0 0
0 0 0 0 0 0 0 0 0 0 0 0 0 0 0 0