16 12
0 0 0 0 0 0 0 0 0 0 0 0 0 0 0 0
0 0 0 0 0 0 0 0 0 0 0 0 0 0 0 0
0 0 0 0 0 0 0 0 0 0 0 0 0 0 0 0
0 0 0 0 0 1 1 1 0 0 0 2 0 0 0 0
0 0 0 0 0 0 4 1 0 0 1 1 0 0 0 0
0 0 0 0 0 0 3 0 0 0 1 0 0 0 0 0
0 0 0 7 6 0 0 0 0 0 1 0 0 0 0 0
0 0 0 8 1 1 5 1 1 5 1 0 0 0 0 0
0 0 0 0 0 1 1 1 1 1 1 0 0 0 0 0
0 0 0 0 0 0 0 0 0 0 0 0 0 0 0 0
0 0 0 0 0 0 0 0 0 0 0 0 0 0 0 0
0 0 0 0 0 0 0 0 0 0 0 0 0 0 0 0